1111111111111
10G10000000C1
1000011111001
1P0G11E000001
1111111111111